* Just listening to melodies, not the words and the meanings *

Metis - All In (feat. Aynzli Jones, Radio Edit)
The Flirts - Helpless
Ida Corr, Shaggy - Under The Sun (Lenny Ibizarre Remix)
Carla Morrison - Disfruto
Lasgo - Feeling Alive (Extended Mix)
Ocean Jet - Unfettered
Heiko & Maiko - Glücklich
Yotto, Something Good, Karolus Viitala - Rhythm (Of The Night)
Sylver, Angemi, Dave Crusher - Losing My Religion
The Sounds - Beatbox
Kleerup, Titiyo - Longing for Lullabies
Titiyo - Come Along
Sarah Brightman - Nessun Dorma
Oana Radu, Dr Mako, Eli - Tu
Fake Blood - I Think I Like it
DR. KUCHO! - La Isla (Original mix)
Nalin & Kane - Beachball (Extended Vocal Mix)
Pakito - Harmony
Paolo Conte - Sparring Partner
Climber - Equal Responsibility
LVNDSCAPE, Rat City - Down Under
Alex Christensen, The Berlin Orchestra - Sandstorm
Alex Christensen, The Berlin Orchestra, Mandy Capristo - Fade To Grey
Alex Christensen, The Berlin Orchestra, Melanie C - Around the World
Emma - L'Amore Non Mi Basta
Zager & Evans - In the Year 2525 (Exordium & Terminus)
Indila - Run Run
Indila - Love Story (Live From Spotify Paris)
Iron Maiden - Hallowed Be Thy Name (1998 Remaster)
ATB - Ecstacy (Intro Edit)
Giusy Ferreri - Momenti perfetti
Of Monsters and Men - Little Talks
Renee - Sales
Era - Ameno (The Scientist remix)
Jemme - Butterfly
Sash!, Tina Cousins, John B.Norman - Mysterious Times (John B.Norman Mix) 
Reamonn - Supergirl
J Balvin, Willy William - Mi Gente
Lana Del Rey - Summertime Sadness (Asadinho Vocal mix)
Faun - Federkleid
ATB, Heather Nova - Renegade A&T remix
AnnenMayKantereit, Giant Rocks - Tom's Diner
Sukhwinder Singh, Sapna Awasthi - Chaiyaa Chaiyaa
Dhamika - Pashupati
E-Type - Dans La Fantasie
Marc Philippe - We were younger
Rollergirl - It's a fine day
Sabrina Carpenter - Thumbs
Enrique Iglesias & co - Bailando (Spanish version)
Louise Attaque - J't'emmène au vent
Shinnobu - Of Return to Mysticism
Harry Chapin - Cats in the Cradle
Bad Boys Blues - A Train to Nowhere
Gigi D'Agostino, Sud Sound System - Radici Dag
Mahmut Orhan, Boral Kibil - Fringe
Franco Battiato, Alice - I Treni Di Tozeur (2005)
Matchbox Twenty - Let's see how far We've come
Dj Pantelis, Nick Saley - Sweet Lullaby
Bang Bang Romeo - What's up?
Gigi Dagostino - Vorrei Fare Una Canzone (Gigi D'Agostino Tanz)
Argus - Elusive Peace